NO ./assest/a.xpm
SO ./assest/b.xpm
WE ./assest/c.xpm
EA      ./assest/d.xpm
F 228,230,168
C 198,197,139


 11111111111111111
1W1
 1