NO ./assest/br.xpm
SO ./path_to_the_south_texture
WE ./path_to_the_west_texture
EA ./path_to_the_east_texture
F 228,230,168
C 198,197,139

1111111111
1000000001
1000N00001
1111111111