NO ./assest/a.xpm
SO ./assest/b.xpm
WE ./assest/c.xpm
EA      ./assest/d.xpm
F 228,230,168
C 198,197,139

1111111
1000001
1000001
1000101
1001N01
1111111