NO ./assest/a.xpm
SO ./assest/b.xpm
WE ./assest/c.xpm
EA      ./assest/d.xpm
F 228,230,168
C 198,197,139

1111111111
10000N001
1111111111
