NO ./assest/a.xpm
SO ./assest/b.xpm
WE ./assest/c.xpm
EA      ./assest/d.xpm
F 228,230,168
C 198,197,139

1111
1101
1S11
1111