NO ./assest/BRICK1.xpm
SO ./assest/BRICK2.xpm
WE ./assest/BRICK3.xpm
EA      ./assest/BRICK4.xpm
F 0,102,0
C 153,51,8

1111111111
10000N001
1111111111
